0: (10) [' ', ' ', 'd', ' ', ' ', 'd', ' ', ' ', ' ', ' ']
1: (10) [' ', ' ', ' ', 'd', ' ', ' ', 'd', ' ', ' ', ' ']
2: (10) [' ', ' ', 'd', ' ', ' ', 'd', ' ', ' ', ' ', ' ']
3: (10) [' ', ' ', ' ', ' ', ' ', ' ', ' ', ' ', ' ', ' ']
4: (10) ['d', 'd', 'd', 'd', 'd', 'd', 'd', 'd', ' ', ' ']
5: (10) ['d', ' ', ' ', ' ', ' ', ' ', ' ', 'd', 'd', ' ']
6: (10) ['d', ' ', ' ', ' ', ' ', ' ', ' ', 'd', ' ', 'd']
7: (10) ['d', ' ', ' ', ' ', ' ', ' ', ' ', 'd', 'd', ' ']
8: (10) [' ', 'd', ' ', ' ', ' ', ' ', 'd', ' ', ' ', ' ']
9: (10) [' ', ' ', 'd', 'd', 'd', 'd', ' ', ' ', ' ', ' ']